date,MAS_IPSP,CC,CREEMOS,FPV,PAN_BOL,ADN,LIBRE_21,JUNTOS,VOTO_VALIDO,VOTO_BLANCO,VOTO_NULO,VOTO_EMITIDO,INSCRITOS_HABILITADOS
Invalid Date,0,0,0,0,0,0,0,0,0,0,0,0,0
2020-10-18T19:36:55Z,11315,12994,1661,452,174,3,4,0,26603,198,889,27690,34800
2020-10-18T19:46:55Z,14088,17348,1941,551,190,2,3,0,34123,267,1098,35488,43276
2020-10-18T20:10:44Z,21271,28872,3507,828,292,0,0,0,54770,432,1802,57004,67886
2020-10-18T20:30:41Z,28662,40040,5198,1108,368,0,0,0,75376,580,2440,78396,93192
2020-10-18T21:10:41Z,48582,82795,12886,2303,702,2,1,0,147271,1201,5168,153640,179988
2020-10-18T21:28:35Z,61109,101328,19218,2850,840,7,2,0,185354,1474,6544,193372,224659
2020-10-18T21:48:35Z,72481,117359,28128,3289,947,12,3,0,222219,1792,7838,231849,268409
2020-10-18T22:18:34Z,91424,145095,38935,4203,1189,15,6,0,280867,2332,9967,293166,337923
2020-10-18T22:28:35Z,102357,157216,44260,4648,1315,17,7,0,309820,2597,11183,323600,373292
2020-10-18T22:48:34Z,117085,175646,50666,5287,1455,21,11,0,350171,2943,12787,365901,421557
2020-10-18T23:08:35Z,129871,191653,61763,5828,1596,22,12,0,390745,3287,14295,408327,469722
2020-10-19T00:18:36Z,184115,257140,92492,8445,2342,39,178,0,544751,4688,20292,569731,654324
2020-10-19T00:38:34Z,195265,270096,98880,8930,2480,41,180,0,575872,5015,21532,602419,690897
2020-10-19T00:48:34Z,207149,283313,104547,9450,2656,43,182,0,607340,5364,22958,635662,727810
2020-10-19T01:08:33Z,225702,300360,120651,10178,2849,43,185,0,659968,5905,24956,690829,790069
2020-10-19T01:28:34Z,241425,316821,129447,10927,3053,46,187,0,701906,6456,26941,735303,840032
2020-10-19T01:48:33Z,258919,338784,140148,11759,3269,50,189,0,753118,6922,28911,788951,899704
2020-10-19T02:18:34Z,282459,367348,159647,12723,3554,59,192,0,825982,7563,31634,865179,985049
2020-10-19T02:28:34Z,289192,375164,163854,13020,3634,60,192,0,845116,7746,32502,885364,1007748
2020-10-19T02:48:34Z,298251,383071,174870,13349,3708,62,194,0,873505,7965,33797,915267,1041454
2020-10-19T03:08:34Z,321595,409643,191581,14460,4007,67,198,0,941551,8558,36486,986595,1123153
2020-10-19T03:28:34Z,330095,421253,194731,14893,4117,71,200,0,965360,8858,37428,1011646,1151793
2020-10-19T03:48:34Z,331727,424006,194929,15029,4141,69,200,0,970101,8945,37655,1016701,1157634
2020-10-19T04:18:34Z,335823,430749,195461,15321,4192,69,200,0,981815,9115,38211,1029141,1172019
2020-10-19T04:28:34Z,335942,430990,195471,15333,4193,69,200,0,982198,9124,38223,1029545,1172459
2020-10-19T04:48:34Z,337217,434306,195774,15410,4204,69,200,0,987180,9172,38425,1034777,1178732
2020-10-19T05:08:34Z,337217,434306,195774,15410,4204,69,200,0,987180,9172,38425,1034777,1178732
2020-10-19T05:28:34Z,337217,434306,195774,15410,4204,69,200,0,987180,9172,38425,1034777,1178732
2020-10-19T05:38:34Z,337217,434306,195774,15410,4204,69,200,0,987180,9172,38425,1034777,1178732
2020-10-19T06:18:34Z,345085,440314,195983,15568,4246,69,200,0,1001465,9275,38792,1049532,1194915
2020-10-19T06:38:34Z,348836,443789,196084,15664,4279,69,200,0,1008921,9328,39019,1057268,1203433
2020-10-19T06:48:34Z,351221,446373,196161,15720,4297,69,200,0,1014041,9359,39172,1062572,1209298
2020-10-19T07:08:34Z,355511,450960,196491,15801,4344,69,200,0,1023376,9421,39469,1072266,1220585
2020-10-19T07:28:34Z,365984,459676,198191,16088,4431,69,200,0,1044639,9556,40108,1094303,1247434
2020-10-19T07:48:34Z,376761,466147,203404,16369,4543,70,204,0,1067498,9772,40988,1118258,1274506
2020-10-19T08:18:34Z,395232,483272,209599,17024,4778,75,206,0,1110186,10154,42563,1162903,1325732
2020-10-19T08:28:34Z,402043,487310,211149,17240,4862,78,206,0,1122888,10249,43071,1176208,1342173
2020-10-19T08:48:34Z,412269,495132,215211,17537,5007,80,207,0,1145443,10444,43892,1199779,1371191
2020-10-19T09:18:34Z,434254,519281,222073,18399,5267,82,210,0,1199566,10843,45581,1255990,1434671
2020-10-19T09:28:34Z,445092,529477,223973,18712,5352,83,210,0,1222899,11074,46416,1280389,1461805
2020-10-19T09:48:34Z,465232,550342,225705,19449,5611,85,210,0,1266634,11514,47924,1326072,1513043
2020-10-19T10:18:34Z,490423,565582,230689,20315,5861,89,329,0,1313288,12171,49641,1375100,1568322
2020-10-19T10:38:34Z,511133,579862,236246,20920,6017,92,408,0,1354678,12533,50939,1418150,1617295
2020-10-19T10:48:34Z,517943,585000,237524,21104,6088,92,408,0,1368159,12662,51288,1432109,1633512
2020-10-19T11:08:34Z,541999,597704,244037,21916,6345,98,408,0,1412507,13238,52827,1478572,1688822
2020-10-19T11:28:34Z,556012,605978,248917,22385,6512,98,408,0,1440310,13695,53843,1507848,1721705
2020-10-19T11:48:34Z,575679,617246,261347,23111,6731,101,412,0,1484627,14493,55791,1554911,1776037
2020-10-19T12:18:34Z,601114,632455,289543,23938,6928,106,415,0,1554499,15229,58621,1628349,1859821
2020-10-19T12:38:34Z,623910,647319,305437,24752,7149,112,415,0,1609094,15936,60966,1685996,1924701
2020-10-19T12:48:35Z,631730,654132,309625,25028,7242,113,415,0,1628285,16183,61601,1706069,1947297
2020-10-19T13:08:34Z,653271,669796,322596,25799,7435,116,424,0,1679437,16824,63508,1759769,2007829
2020-10-19T13:28:34Z,670807,680562,329960,26381,7612,127,432,0,1715881,17280,64841,1798002,2051767
2020-10-19T13:48:34Z,684831,687395,335266,26798,7757,132,524,0,1742703,17669,65934,1826306,2084965
2020-10-19T14:18:35Z,711391,704002,349996,27639,8012,141,527,0,1801708,18556,68259,1888523,2155542
2020-10-19T14:28:34Z,723267,710304,352938,28049,8130,143,527,0,1823358,18953,69271,1911582,2181749
2020-10-19T14:48:34Z,742765,720352,357628,28597,8300,143,531,0,1858316,19558,70602,1948476,2223597
2020-10-19T15:08:35Z,764873,731792,363480,29246,8518,147,538,0,1898594,20325,72241,1991160,2271093
2020-10-19T15:28:34Z,779566,739357,369095,29682,8667,153,541,0,1927061,20797,73460,2021318,2305433
2020-10-19T15:48:34Z,805320,754155,379974,30515,8887,159,549,0,1979559,21438,75313,2076310,2366508
2020-10-19T16:08:35Z,826259,766253,386136,31106,9112,159,549,0,2019574,22077,76856,2118507,2414250
2020-10-19T16:28:34Z,847919,775102,390507,31715,9314,161,580,0,2055298,22681,78180,2156159,2456453
2020-10-19T16:48:34Z,866931,785850,397298,32313,9561,164,583,0,2092700,23227,79730,2195657,2500945
2020-10-19T17:08:35Z,884013,795043,406922,32851,9696,168,590,0,2129283,23815,81269,2234367,2544578
2020-10-19T17:28:34Z,904800,806405,415935,33546,9887,172,629,0,2171374,24504,82977,2278855,2594743
2020-10-19T17:48:35Z,922218,814488,424585,34113,10083,175,632,0,2206294,25136,84627,2316057,2636850
2020-10-19T18:48:35Z,1009015,844212,435859,36165,10831,184,637,0,2336903,27411,89690,2454004,2793805
2020-10-19T19:38:35Z,1081904,873326,439192,38050,11544,189,645,0,2444850,29323,93441,2567614,2924702
2020-10-19T19:48:35Z,1097431,877811,440354,38393,11685,190,645,0,2466509,29690,94248,2590447,2950939
2020-10-19T20:18:35Z,1137197,894364,449368,39539,12065,193,649,0,2533375,31043,97038,2661456,3031118
2020-10-19T20:28:35Z,1151591,900683,453481,39926,12182,196,650,0,2558709,31597,98211,2688517,3061739
2020-10-19T20:48:35Z,1181925,914297,458197,40787,12453,202,657,0,2608518,32587,100362,2741467,3121322
2020-10-19T21:08:35Z,1207002,926900,465090,41532,12675,208,664,0,2654071,33422,102328,2789821,3175529
2020-10-19T21:28:35Z,1237877,940503,473787,42484,12943,213,672,0,2708479,34443,104740,2847662,3240524
2020-10-19T21:48:35Z,1270075,956300,481640,43325,13185,219,746,0,2765490,35191,106795,2907476,3307266
2020-10-19T22:18:35Z,1327504,981890,489688,44847,13702,238,760,0,2858629,37135,110557,3006321,3417586
2020-10-19T22:28:35Z,1349468,989434,491707,45485,13886,242,768,0,2890990,37865,111870,3040725,3456421
2020-10-19T22:48:35Z,1387193,1007066,497009,46541,14257,243,770,0,2953079,39036,114339,3106454,3531110
2020-10-19T23:08:35Z,1420454,1023840,504462,47532,14567,255,785,0,3011895,40269,116959,3169123,3601986
2020-10-19T23:28:35Z,1457213,1038034,511323,48502,14909,261,797,0,3071039,41410,119442,3231891,3672809
2020-10-19T23:48:35Z,1492356,1051178,518604,49379,15186,270,805,0,3127778,42306,121439,3291523,3739262
2020-10-20T00:18:35Z,1548883,1075654,530722,50859,15718,276,840,0,3222952,43750,125292,3391994,3850979
2020-10-20T13:48:02Z,2264367,1340727,655940,68158,21857,453,929,0,4352431,62508,165950,4580889,5213140
2020-10-20T14:28Z,2329615,1361801,668301,69831,22485,469,940,0,4453442,64524,170220,4688186,5332644
2020-10-20T14:48Z,2359351,1378394,676836,70731,22782,484,953,0,4509531,65355,172394,4747280,5398481
2020-10-20T15:07:59Z,2398536,1396004,685890,71683,23128,498,957,0,4576696,66334,174912,4817942,5478549
2020-10-20T15:27:59Z,2428847,1407020,695724,72423,23458,508,1002,0,4628982,67343,177119,4873444,5541891
2020-10-20T15:47:59Z,2461762,1416182,705134,73266,23744,517,1015,0,4681620,68390,179274,4929284,5605029
2020-10-20T16:07:59Z,2505110,1429246,710269,74163,24131,530,1026,0,4744475,69351,181325,4995151,5679159
2020-10-20T16:27:59Z,2549586,1444086,719364,75313,24581,539,1086,0,4814555,70435,183995,5068985,5762997
2020-10-20T16:47:59Z,2565335,1448009,722488,75635,24686,538,1088,0,4837779,70811,184911,5093501,5790248
2020-10-20T17:07:59Z,2575537,1451226,725056,75964,24802,539,1094,0,4854218,71124,185603,5110945,5809779
2020-10-20T17:27:59Z,2593804,1457722,728384,76452,24955,540,1096,0,4882953,71529,186826,5141308,5845803
2020-10-20T17:47:59Z,2621673,1465005,730275,77028,25178,540,1096,0,4920795,72276,188239,5181310,5890497
2020-10-20T18:47:59Z,2713871,1494852,749577,78823,25817,568,1115,0,5064623,74453,193159,5332235,6061156
2020-10-20T19:27:59Z,2754093,1511478,751178,79539,26038,570,1116,0,5124012,75239,194896,5394147,6130297
2020-10-20T19:47:59Z,2776961,1521896,754395,79981,26151,570,1116,0,5161070,75739,196104,5432913,6174054
2020-10-20T20:07:59Z,2790069,1528288,757739,80259,26236,575,1129,0,5184295,76141,197198,5457634,6202304
2020-10-20T20:27:59Z,2807155,1535069,758037,80657,26404,575,1129,0,5209026,76656,198027,5483709,6231384
2020-10-20T20:48Z,2814954,1539414,758261,80902,26516,575,1129,0,5221751,76986,198580,5497317,6246499
2020-10-20T21:08Z,2826750,1547590,758536,81157,26611,576,1129,0,5242349,77166,199234,5518749,6270095
2020-10-20T21:27:59Z,2829185,1548445,758548,81217,26661,576,1129,0,5245761,77252,199334,5522347,6274098
2020-10-20T21:47:59Z,2832909,1549085,758573,81277,26707,576,1129,0,5250256,77356,199469,5527081,6279316
2020-10-20T22:07:59Z,2833675,1549430,758583,81291,26709,576,1152,0,5251416,77371,199494,5528281,6280636
2020-10-20T22:27:59Z,2837660,1550637,758619,81373,26734,576,1152,0,5256751,77467,199616,5533834,6286735
2020-10-20T22:48Z,2840987,1552259,758684,81506,26787,579,1152,0,5261954,77625,199830,5539409,6292939
2020-10-20T23:08Z,2842930,1552721,758726,81551,26811,576,1153,0,5264468,77752,199941,5542161,6296109
2020-10-20T23:27:59Z,2846415,1554513,758872,81733,26908,577,1153,0,5270171,77946,200242,5548359,6303077
2020-10-20T23:48Z,2847026,1555034,758881,81754,26916,577,1153,0,5271341,77954,200274,5549569,6304478
2020-10-21T00:08Z,2847448,1555800,758933,81769,26929,577,1153,0,5272609,77967,200324,5550900,6305979
2020-10-21T00:28Z,2850785,1557645,759046,81892,26976,577,1153,0,5278074,78104,200628,5556806,6312572
2020-10-21T00:47:59Z,2852412,1558550,759103,81961,27013,577,1174,0,5280790,78224,200754,5559768,6315867
2020-10-21T01:07:59Z,2852412,1558550,759103,81961,27013,577,1174,0,5280790,78224,200754,5559768,6315867
2020-10-21T01:28Z,2852412,1558550,759103,81961,27013,577,1174,0,5280790,78224,200754,5559768,6315867
2020-10-21T01:47:59Z,2853516,1559532,759155,82035,27038,577,1175,0,5283028,78292,200847,5562167,6318571
2020-10-21T02:07:59Z,2853875,1559965,759177,82053,27046,580,1175,0,5283871,78303,200871,5563045,6319571
2020-10-21T02:27:59Z,2854173,1560009,759178,82063,27050,580,1177,0,5284230,78313,200891,5563434,6320011
2020-10-21T02:48Z,2854173,1560009,759178,82063,27050,580,1177,0,5284230,78313,200891,5563434,6320011
2020-10-21T03:08Z,2854173,1560009,759178,82063,27050,580,1177,0,5284230,78313,200891,5563434,6320011
2020-10-21T03:28Z,2854173,1560009,759178,82063,27050,580,1177,0,5284230,78313,200891,5563434,6320011
2020-10-21T03:47:59Z,2854173,1560009,759178,82063,27050,580,1177,0,5284230,78313,200891,5563434,6320011
2020-10-21T04:07:59Z,2854173,1560009,759178,82063,27050,580,1177,0,5284230,78313,200891,5563434,6320011
2020-10-21T04:27:59Z,2854173,1560009,759178,82063,27050,580,1177,0,5284230,78313,200891,5563434,6320011
2020-10-21T04:47:59Z,2855769,1560137,759193,82132,27088,580,1179,0,5286078,78412,201003,5565493,6322286
2020-10-21T05:07:59Z,2863701,1561577,759253,82369,27238,580,1179,0,5295897,78625,201312,5575834,6333482
2020-10-21T05:27:59Z,2867228,1563580,759295,82448,27274,580,1179,0,5301584,78714,201501,5581799,6339982
2020-10-21T05:47:59Z,2872254,1565718,759356,82549,27322,580,1179,0,5308958,78815,201649,5589422,6348335
2020-10-21T06:08Z,2876428,1566637,759415,82691,27372,580,1179,0,5314302,78989,201843,5595134,6354609
2020-10-21T06:28Z,2887009,1568641,759481,82975,27507,581,1156,0,5327350,79267,202307,5608924,6369544
2020-10-21T06:48Z,2899479,1572240,761284,83300,27631,583,1156,0,5345673,79612,202900,5628185,6390461
2020-10-21T07:08Z,2917909,1576334,761434,83682,27806,583,1156,0,5368904,80069,203536,5652509,6416656
2020-10-21T07:27:59Z,2926942,1579278,761512,83943,27901,583,1158,0,5381317,80243,203874,5665434,6430686
2020-10-21T07:47:59Z,2927780,1579596,761525,83949,27901,583,1158,0,5382492,80253,203889,5666634,6432006
2020-10-21T08:08Z,2928853,1579862,761531,83976,27905,583,1158,0,5383868,80276,203929,5668073,6433546
2020-10-21T08:28Z,2930807,1580449,762011,84029,27929,585,1160,0,5386970,80313,204033,5671316,6437069
2020-10-21T08:48Z,2930849,1580428,762011,84027,27926,585,1160,0,5386986,80312,204025,5671323,6437069
2020-10-21T09:07:59Z,2934274,1582154,762079,84155,27958,584,1160,0,5392364,80432,204265,5677061,6443537
2020-10-21T09:28Z,2939744,1583782,762846,84345,28014,590,1160,0,5400481,80681,204643,5685805,6453386
2020-10-21T09:48Z,2947870,1586770,764825,84677,28102,594,1068,0,5413906,81008,205309,5700223,6469629
2020-10-21T10:07:59Z,2951218,1587938,764939,84759,28128,593,1068,0,5418643,81101,205469,5705213,6475043
2020-10-21T10:28Z,2955921,1589998,764991,84864,28159,591,1068,0,5425592,81165,205738,5712495,6482992
2020-10-21T10:47:59Z,2957634,1590720,765669,84916,28164,592,1074,0,5428769,81215,205850,5715834,6486685
2020-10-21T11:08Z,2959649,1591348,766248,84957,28184,593,1069,0,5432048,81291,205964,5719303,6490525
2020-10-21T11:28Z,2961087,1591553,766353,84994,28179,589,1066,0,5433821,81303,205988,5721112,6492371
2020-10-21T11:48Z,2962990,1592165,766850,85011,28197,582,1065,0,5436860,81364,206077,5724301,6495970
2020-10-21T12:08Z,2965382,1593152,767527,85036,28198,569,1059,0,5440923,81335,206135,5728393,6500366
2020-10-21T12:28Z,2965060,1592956,767342,85009,28185,559,1049,0,5440160,81256,206004,5727420,6499300
2020-10-21T12:48Z,2967166,1593570,767459,84979,28169,540,1020,0,5442903,81171,206041,5730115,6502184
2020-10-21T13:08Z,2966631,1592154,767494,84934,28162,535,1015,0,5440925,81130,205987,5728042,6499834
2020-10-21T13:28Z,2967593,1592985,767874,84958,28172,529,1011,0,5443122,81140,206023,5730285,6502292
2020-10-21T13:48Z,2972310,1595839,769166,85057,28184,514,1008,0,5452078,81170,206281,5739529,6512551
2020-10-21T14:08Z,2979545,1598314,769679,85203,28247,509,999,0,5462496,81371,206624,5750491,6524595
2020-10-21T14:28Z,2983863,1602016,770501,85328,28277,498,989,0,5471472,81568,207186,5760226,6535489
2020-10-21T14:48Z,2985973,1603003,772248,85343,28287,499,981,0,5476334,81594,207433,5765361,6541233
2020-10-21T15:08Z,2988854,1604651,773354,85451,28346,494,967,0,5482117,81680,207601,5771398,6547938
2020-10-21T15:28Z,2989476,1604572,773316,85429,28344,480,957,0,5482574,81655,207636,5771865,6548453
2020-10-21T15:48Z,2990535,1605444,775087,85500,28348,476,934,0,5486324,81670,207840,5775834,6552784
2020-10-21T16:08Z,2991726,1605967,776146,85511,28353,475,915,0,5489093,81794,207920,5778807,6556110
2020-10-21T16:28Z,2992227,1605715,776966,85532,28355,470,898,0,5490163,81801,207966,5779930,6557187
2020-10-21T16:48Z,2996109,1607286,779507,85665,28393,466,893,0,5498319,81948,208435,5788702,6567182
2020-10-21T17:08Z,3003097,1610606,780605,85764,28426,462,893,0,5509853,82100,208741,5800694,6580449
2020-10-21T17:28Z,3006872,1611570,782509,85813,28434,458,883,0,5516539,82082,208958,5807579,6588028
2020-10-21T17:48Z,3010278,1613512,783553,85934,28465,457,877,0,5523076,82207,209216,5814499,6595854
2020-10-21T18:48Z,3021670,1617808,790090,86213,28580,464,881,0,5545706,82684,210141,5838531,6622852
2020-10-21T19:28Z,3025133,1619764,790313,86302,28600,465,882,0,5551459,82744,210317,5844520,6629407
2020-10-21T19:48Z,3032617,1623198,798794,86509,28636,472,919,0,5571145,82919,211077,5865141,6652457
2020-10-21T20:08Z,3039682,1625909,803906,86684,28681,480,929,0,5586271,83111,211834,5881216,6670404
2020-10-21T20:27:59Z,3043464,1627093,804793,86742,28709,481,932,0,5592214,83192,212067,5887473,6677339
2020-10-21T20:48Z,3049016,1629182,805190,86830,28729,481,932,0,5600360,83259,212289,5895908,6686636
2020-10-21T21:07:59Z,3054206,1631288,805280,86923,28758,481,932,0,5607868,83361,212501,5903730,6695327
2020-10-21T21:27:59Z,3055476,1631780,805520,86959,28765,483,933,0,5609916,83393,212550,5905859,6697691
2020-10-21T21:48Z,3056193,1632101,806247,86988,28777,484,935,0,5611725,83457,212644,5907826,6699937
2020-10-21T22:08Z,3058356,1632885,808060,87076,28796,486,938,0,5616597,83544,212889,5913030,6705898
2020-10-21T22:28Z,3062766,1635385,809641,87176,28834,487,946,0,5625235,83662,213261,5922158,6716086
2020-10-21T22:48Z,3063675,1635992,811460,87212,28842,488,952,0,5628621,83728,213465,5925814,6720359
2020-10-21T23:08Z,3064908,1636569,812928,87238,28854,492,955,0,5631944,83778,213570,5929292,6724210
2020-10-21T23:27:59Z,3069075,1638813,814477,87372,28877,498,962,0,5640074,83891,213885,5937850,6733781
2020-10-21T23:48Z,3074471,1642108,814945,87505,28923,504,963,0,5649419,83996,214169,5947584,6744464
2020-10-22T00:08Z,3078514,1644949,815424,87609,28963,507,970,0,5656936,84086,214423,5955445,6753126
2020-10-22T00:28Z,3085674,1649070,815930,87806,29020,508,970,0,5668978,84198,214808,5967984,6766852
2020-10-22T00:47:59Z,3091363,1652428,816791,87946,29059,513,977,0,5679077,84307,215114,5978498,6778424
2020-10-22T01:08Z,3099147,1656817,816896,88115,29129,513,977,0,5691594,84411,215480,5991485,6792540
2020-10-22T01:28Z,3103878,1659451,819688,88270,29182,516,980,0,5701965,84603,215974,6002542,6805033
2020-10-22T01:47:59Z,3105186,1660063,820024,88300,29191,517,983,0,5704264,84669,216088,6005021,6807736
2020-10-22T02:08Z,3106821,1661032,820888,88339,29203,522,985,0,5707790,84729,216240,6008759,6811877
2020-10-22T02:28Z,3111839,1663891,822780,88480,29240,528,995,0,5717753,84885,216636,6019274,6823534
2020-10-22T02:48Z,3116168,1665713,825582,88615,29287,539,1001,0,5726905,85017,216989,6028911,6834319
2020-10-22T03:08Z,3116955,1666168,826769,88636,29295,539,1001,0,5729363,85040,217048,6031451,6837179
2020-10-22T03:28Z,3116955,1666168,826769,88636,29295,539,1001,0,5729363,85040,217048,6031451,6837179
2020-10-22T03:48Z,3117117,1666196,826771,88639,29298,539,1001,0,5729561,85042,217053,6031656,6837399
2020-10-22T04:08Z,3119593,1667399,826800,88696,29330,539,1033,0,5733390,85071,217158,6035619,6841680
2020-10-22T04:28Z,3120487,1668183,826823,88727,29338,539,1033,0,5735130,85083,217200,6037413,6843660
2020-10-22T04:48Z,3121681,1668689,826828,88750,29347,539,1033,0,5736867,85097,217281,6039245,6845640
2020-10-22T05:08Z,3121681,1668689,826828,88750,29347,539,1033,0,5736867,85097,217281,6039245,6845640
2020-10-22T05:28Z,3122496,1668935,826831,88767,29353,539,1033,0,5737954,85111,217330,6040395,6846880
2020-10-22T05:48Z,3127285,1671380,826898,88868,29394,539,1033,0,5745397,85196,217561,6048154,6855254
2020-10-22T06:08Z,3130883,1672543,826937,88927,29415,539,1033,0,5750277,85254,217699,6053230,6860754
2020-10-22T06:27:59Z,3137164,1674605,826985,89054,29472,542,1040,0,5758862,85402,217938,6062202,6870434
2020-10-22T06:47:59Z,3143282,1677406,827071,89188,29502,542,1040,0,5768031,85505,218178,6071714,6880917
2020-10-22T07:08Z,3144776,1677793,827086,89207,29511,542,1040,0,5769955,85527,218244,6073726,6883117
2020-10-22T07:27:59Z,3150170,1679766,830348,89335,29541,545,1045,0,5780750,85652,218646,6085048,6895794
2020-10-22T07:48Z,3153412,1681210,831099,89413,29571,550,1046,0,5786301,85773,218892,6090966,6902464
2020-10-22T08:08Z,3162165,1686342,832305,89632,29630,551,1049,0,5801674,85897,219370,6106941,6919994
2020-10-22T08:27:59Z,3165906,1687873,834940,89722,29670,551,1052,0,5809714,85982,219728,6115424,6929502
2020-10-22T08:48Z,3178930,1694952,836817,90088,29761,555,1070,0,5832173,86217,220405,6138795,6955285
2020-10-22T09:07:59Z,3182221,1696274,838107,90167,29785,563,1075,0,5838192,86318,220653,6145163,6962356
2020-10-22T09:27:59Z,3184422,1696713,838673,90207,29798,566,1079,0,5841458,86389,220836,6148683,6966286
2020-10-22T09:48Z,3189233,1698221,842537,90340,29832,568,1088,0,5851819,86571,221250,6159640,6978535
2020-10-22T10:08Z,3191911,1699225,843992,90418,29851,568,1089,0,5857054,86681,221478,6165213,6984732
2020-10-22T10:28Z,3194633,1699829,844064,90453,29874,567,1090,0,5860510,86734,221580,6168824,6988660
2020-10-22T10:48Z,3198221,1702042,844113,90516,29916,568,1092,0,5866468,86798,221776,6175042,6995496
2020-10-22T11:08Z,3204799,1704367,844804,90676,29967,567,1097,0,5876277,86894,222070,6185241,7006545
2020-10-22T11:28Z,3208843,1705746,844960,90748,29999,567,1097,0,5881960,87004,222297,6191261,7013024
2020-10-22T11:48Z,3213224,1707393,844982,90857,30032,562,1091,0,5888141,87044,222544,6197729,7019948
2020-10-22T12:08Z,3218895,1712125,845084,90988,30060,551,1064,0,5898767,87104,222853,6208724,7032121
2020-10-22T12:28Z,3217836,1712346,845393,90960,30053,550,1052,0,5898190,87048,222877,6208115,7031572
2020-10-22T12:48Z,3218405,1712329,845414,90980,30067,548,1052,0,5898795,87086,222933,6208814,7032353
2020-10-22T13:08Z,3220144,1712708,845466,90984,30048,540,1051,0,5900941,87136,223036,6211113,7034980
2020-10-22T13:28Z,3219930,1713232,845487,90984,30046,533,1047,0,5901259,87134,223097,6211490,7035557
2020-10-22T13:48Z,3222404,1714126,845736,91011,30040,517,1043,0,5904877,87219,223258,6215354,7039898
2020-10-22T14:08Z,3215871,1713947,845726,90899,29974,490,982,0,5897889,87067,223091,6208047,7032057
2020-10-22T14:28Z,3215592,1714582,845967,90902,29968,473,896,0,5898380,87022,223125,6208527,7032599
2020-10-22T14:48Z,3218283,1715345,846138,90927,29956,444,881,0,5901974,86956,223196,6212126,7036367
2020-10-22T15:08Z,3223909,1717339,846366,91067,30017,429,732,0,5909859,87025,223532,6220416,7045266
2020-10-22T15:28Z,3230700,1719059,846423,91164,30072,427,725,0,5918570,87179,223798,6229547,7055207
2020-10-22T15:48Z,3232507,1720356,846428,91198,30104,415,662,0,5921670,87213,223927,6232810,7058742
2020-10-22T16:08Z,3232066,1721822,847251,91182,30113,399,650,0,5923483,87267,223984,6234734,7060998
2020-10-22T16:28Z,3235391,1723576,847280,91278,30146,394,642,0,5928707,87323,224136,6240166,7066909
2020-10-22T16:48Z,3237377,1724193,847392,91319,30154,390,637,0,5931462,87348,224228,6243038,7069979
2020-10-22T17:08Z,3242023,1724635,847572,91392,30208,390,637,0,5936857,87487,224392,6248736,7076144
2020-10-22T17:28Z,3257745,1727967,847697,91712,30361,390,635,0,5956507,87809,225118,6269434,7098405
2020-10-22T17:48Z,3262805,1729311,847819,91876,30424,390,635,0,5963260,87971,225371,6276602,7106166
2020-10-22T18:48Z,3291219,1737251,850533,92532,30749,392,635,0,6003311,88878,226833,6319022,7152498
2020-10-22T19:28Z,3310078,1742545,852504,93001,30932,393,636,0,6030089,89386,227763,6347238,7183412
2020-10-22T19:48Z,3319549,1747413,852730,93252,31042,394,638,0,6045018,89591,228193,6362802,7200517
2020-10-22T20:28Z,3341087,1756775,852962,93815,31226,396,679,0,6076940,90033,229228,6396201,7236937
2020-10-22T20:48Z,3350729,1760413,853791,94080,31330,396,679,0,6091418,90209,229764,6411391,7253436
2020-10-22T21:08Z,3352418,1761359,854407,94129,31339,394,638,0,6094684,90259,229881,6414824,7257238
2020-10-22T21:28Z,3358927,1763110,854921,94296,31415,394,638,0,6103701,90508,230211,6424420,7267770
2020-10-22T21:48Z,3366481,1765560,855306,94499,31496,394,638,0,6114374,90707,230587,6435668,7279966
2020-10-22T22:08Z,3371157,1767448,855469,94624,31553,395,638,0,6121284,90853,230997,6443134,7288328
2020-10-22T22:28Z,3372041,1767788,855707,94656,31563,394,638,0,6122787,90902,231078,6444767,7290135
2020-10-22T22:48Z,3375937,1769001,858542,94757,31601,395,640,0,6130873,91020,231484,6453377,7299669
2020-10-22T23:08Z,3379629,1770421,859787,94864,31639,395,640,0,6137375,91096,231658,6460129,7307045
2020-10-22T23:28Z,3382434,1771311,860521,94939,31657,396,640,0,6141898,91145,231789,6464832,7312208
2020-10-22T23:48Z,3383820,1772466,860927,94978,31664,396,640,0,6144891,91172,231866,6467929,7315619
2020-10-23T00:08Z,3384465,1772683,860932,94995,31665,396,640,0,6145776,91175,231885,6468836,7316584
2020-10-23T00:28Z,3385569,1773079,860946,95029,31682,400,642,0,6147347,91216,231944,6470507,7318399
2020-10-23T00:48Z,3386712,1773375,861285,95058,31689,401,642,0,6149162,91294,232005,6472461,7320505
2020-10-23T01:08Z,3389636,1774356,861318,95138,31715,397,640,0,6153200,91358,232094,6476652,7324987
2020-10-23T01:28Z,3389789,1774436,861350,95139,31729,396,639,0,6153478,91364,232095,6476937,7325324
2020-10-23T01:48Z,3389823,1774683,861356,95138,31730,396,639,0,6153765,91369,232098,6477232,7325649
2020-10-23T02:08Z,3390625,1774803,860952,95152,31738,396,567,0,6154233,91367,232122,6477722,7326189
2020-10-23T02:28Z,3391800,1775179,861309,95182,31750,396,569,0,6156185,91392,232197,6479774,7328444
2020-10-23T02:48Z,3391850,1775238,861578,95184,31751,396,593,0,6156590,91396,232207,6480193,7328884
2020-10-23T03:08Z,3391880,1775271,861858,95186,31751,396,594,0,6156936,91398,232256,6480590,7329324
2020-10-23T03:28Z,3392008,1775319,862060,95187,31752,396,594,0,6157316,91403,232269,6480988,7329764
2020-10-23T03:48Z,3392082,1775362,862118,95188,31752,396,594,0,6157492,91407,232276,6481175,7329984
2020-10-23T04:08Z,3392165,1775380,862171,95193,31754,396,594,0,6157653,91413,232290,6481356,7330204
2020-10-23T04:28Z,3392165,1775380,862171,95193,31754,396,594,0,6157653,91413,232290,6481356,7330204
2020-10-23T04:48Z,3392165,1775380,862171,95193,31754,396,594,0,6157653,91413,232290,6481356,7330204
2020-10-23T05:08Z,3392165,1775380,862171,95193,31754,396,594,0,6157653,91413,232290,6481356,7330204
2020-10-23T05:28Z,3392745,1775515,862176,95212,31765,395,594,0,6158402,91403,232310,6482115,7331008
2020-10-23T05:48Z,3392954,1775577,862176,95218,31766,395,594,0,6158680,91407,232323,6482410,7331331
2020-10-23T06:28Z,3393330,1775737,862181,95230,31767,395,594,0,6159234,91416,232334,6482984,7331952
2020-10-23T06:48Z,3393499,1775855,862182,95235,31768,395,594,0,6159528,91417,232338,6483283,7332266
2020-10-23T07:08Z,3393978,1775943,862184,95245,31770,395,594,0,6160109,91426,232358,6483893,7332926
2020-10-23T07:28Z,3393978,1775943,862184,95245,31770,395,594,0,6160109,91426,232358,6483893,7332926
2020-10-23T07:48Z,3393978,1775943,862184,95245,31770,395,594,0,6160109,91426,232358,6483893,7332926
2020-10-23T08:08Z,3393978,1775943,862184,95245,31770,395,594,0,6160109,91426,232358,6483893,7332926
2020-10-23T20:08Z,3379924,1770258,847547,94747,31643,0,0,0,6124119,90774,231346,6446239,7290843